+-----+-------------------------------------------------------------------------------------------------------------------------------------------------------------------------------------------------------------------------------------------------------------------------------------------------------------------------------------------------------------------------------------------------------------------------------------------------------------------------------------------------------------------------------------------------------------------------------------------------------------------------------------+
|+---+|+---+                                                                                                                                                                                                                                                                                                                                                                                                                                                                                                                                                                                                                                |
||0 0|||0 1|                                                                                                                                                                                                                                                                                                                                                                                                                                                                                                                                                                                                                                |
|+---+|+---+                                                                                                                                                                                                                                                                                                                                                                                                                                                                                                                                                                                                                                |
+-----+-------------------------------------------------------------------------------------------------------------------------------------------------------------------------------------------------------------------------------------------------------------------------------------------------------------------------------------------------------------------------------------------------------------------------------------------------------------------------------------------------------------------------------------------------------------------------------------------------------------------------------------+
|+---+|+-------------------------------------------------------------------+-------------------------------------------------------------------+-------------------------------------------------------------------+-------------------------------------------------------------------+-------------------------------------------------------------------+-------------------------------------------------------------------+-------------------------------------------------------------------+-------------------------------------------------------------------+-------------------------------------------------------------------+|
||1 0|||+-----------+-----------+-----------+-----------------+-----------+|+-----------+-----------+-----------+-----------------+-----------+|+-----------+-----------+-----------+-----------------+-----------+|+-----------+-----------+-----------+-----------------+-----------+|+-----------+-----------+-----------+-----------------+-----------+|+-----------+-----------+-----------+-----------------+-----------+|+-----------+-----------+-----------+-----------------+-----------+|+-----------+-----------+-----------+-----------------+-----------+|+-----------+-----------+-----------+-----------------+-----------+||
|+---+|||+---+-+---+|+---+-+---+|+---+-+---+|+---+-+---+      |+---+-+---+|||+---+-+---+|+---+-+---+|+---+-+---+|+---+-+---+      |+---+-+---+|||+---+-+---+|+---+-+---+|+---+-+---+|+---+-+---+      |+---+-+---+|||+---+-+---+|+---+-+---+|+---+-+---+|+---+-+---+      |+---+-+---+|||+---+-+---+|+---+-+---+|+---+-+---+|+---+-+---+      |+---+-+---+|||+---+-+---+|+---+-+---+|+---+-+---+|+---+-+---+      |+---+-+---+|||+---+-+---+|+---+-+---+|+---+-+---+|+---+-+---+      |+---+-+---+|||+---+-+---+|+---+-+---+|+---+-+---+|+---+-+---+      |+---+-+---+|||+---+-+---+|+---+-+---+|+---+-+---+|+---+-+---+      |+---+-+---+|||
|     ||||1 1|0|0 0|||1 1|0|0 1|||1 1|0|0 2|||1 1|0|0 3|      ||1 1|0|0 4|||||1 1|1|0 0|||1 1|1|0 1|||1 1|1|0 2|||1 1|1|0 3|      ||1 1|1|0 4|||||1 1|2|0 0|||1 1|2|0 1|||1 1|2|0 2|||1 1|2|0 3|      ||1 1|2|0 4|||||1 1|3|0 0|||1 1|3|0 1|||1 1|3|0 2|||1 1|3|0 3|      ||1 1|3|0 4|||||1 1|4|0 0|||1 1|4|0 1|||1 1|4|0 2|||1 1|4|0 3|      ||1 1|4|0 4|||||1 1|5|0 0|||1 1|5|0 1|||1 1|5|0 2|||1 1|5|0 3|      ||1 1|5|0 4|||||1 1|6|0 0|||1 1|6|0 1|||1 1|6|0 2|||1 1|6|0 3|      ||1 1|6|0 4|||||1 1|7|0 0|||1 1|7|0 1|||1 1|7|0 2|||1 1|7|0 3|      ||1 1|7|0 4|||||1 1|8|0 0|||1 1|8|0 1|||1 1|8|0 2|||1 1|8|0 3|      ||1 1|8|0 4||||
|     |||+---+-+---+|+---+-+---+|+---+-+---+|+---+-+---+      |+---+-+---+|||+---+-+---+|+---+-+---+|+---+-+---+|+---+-+---+      |+---+-+---+|||+---+-+---+|+---+-+---+|+---+-+---+|+---+-+---+      |+---+-+---+|||+---+-+---+|+---+-+---+|+---+-+---+|+---+-+---+      |+---+-+---+|||+---+-+---+|+---+-+---+|+---+-+---+|+---+-+---+      |+---+-+---+|||+---+-+---+|+---+-+---+|+---+-+---+|+---+-+---+      |+---+-+---+|||+---+-+---+|+---+-+---+|+---+-+---+|+---+-+---+      |+---+-+---+|||+---+-+---+|+---+-+---+|+---+-+---+|+---+-+---+      |+---+-+---+|||+---+-+---+|+---+-+---+|+---+-+---+|+---+-+---+      |+---+-+---+|||
|     ||+-----------+-----------+-----------+-----------------+-----------+|+-----------+-----------+-----------+-----------------+-----------+|+-----------+-----------+-----------+-----------------+-----------+|+-----------+-----------+-----------+-----------------+-----------+|+-----------+-----------+-----------+-----------------+-----------+|+-----------+-----------+-----------+-----------------+-----------+|+-----------+-----------+-----------+-----------------+-----------+|+-----------+-----------+-----------+-----------------+-----------+|+-----------+-----------+-----------+-----------------+-----------+||
|     |||+---+-+---+|+---+-+---+|+---+-+---+|+---------------+|+---+-+---+|||+---+-+---+|+---+-+---+|+---+-+---+|+---------------+|+---+-+---+|||+---+-+---+|+---+-+---+|+---+-+---+|+---------------+|+---+-+---+|||+---+-+---+|+---+-+---+|+---+-+---+|+---------------+|+---+-+---+|||+---+-+---+|+---+-+---+|+---+-+---+|+---------------+|+---+-+---+|||+---+-+---+|+---+-+---+|+---+-+---+|+---------------+|+---+-+---+|||+---+-+---+|+---+-+---+|+---+-+---+|+---------------+|+---+-+---+|||+---+-+---+|+---+-+---+|+---+-+---+|+---------------+|+---+-+---+|||+---+-+---+|+---+-+---+|+---+-+---+|+---------------+|+---+-+---+|||
|     ||||1 1|0|1 0|||1 1|0|1 1|||1 1|0|1 2|||+---+-+---+---+|||1 1|0|1 4|||||1 1|1|1 0|||1 1|1|1 1|||1 1|1|1 2|||+---+-+---+---+|||1 1|1|1 4|||||1 1|2|1 0|||1 1|2|1 1|||1 1|2|1 2|||+---+-+---+---+|||1 1|2|1 4|||||1 1|3|1 0|||1 1|3|1 1|||1 1|3|1 2|||+---+-+---+---+|||1 1|3|1 4|||||1 1|4|1 0|||1 1|4|1 1|||1 1|4|1 2|||+---+-+---+---+|||1 1|4|1 4|||||1 1|5|1 0|||1 1|5|1 1|||1 1|5|1 2|||+---+-+---+---+|||1 1|5|1 4|||||1 1|6|1 0|||1 1|6|1 1|||1 1|6|1 2|||+---+-+---+---+|||1 1|6|1 4|||||1 1|7|1 0|||1 1|7|1 1|||1 1|7|1 2|||+---+-+---+---+|||1 1|7|1 4|||||1 1|8|1 0|||1 1|8|1 1|||1 1|8|1 2|||+---+-+---+---+|||1 1|8|1 4||||
|     |||+---+-+---+|+---+-+---+|+---+-+---+|||1 1|0|1 3|0 0|||+---+-+---+|||+---+-+---+|+---+-+---+|+---+-+---+|||1 1|1|1 3|0 0|||+---+-+---+|||+---+-+---+|+---+-+---+|+---+-+---+|||1 1|2|1 3|0 0|||+---+-+---+|||+---+-+---+|+---+-+---+|+---+-+---+|||1 1|3|1 3|0 0|||+---+-+---+|||+---+-+---+|+---+-+---+|+---+-+---+|||1 1|4|1 3|0 0|||+---+-+---+|||+---+-+---+|+---+-+---+|+---+-+---+|||1 1|5|1 3|0 0|||+---+-+---+|||+---+-+---+|+---+-+---+|+---+-+---+|||1 1|6|1 3|0 0|||+---+-+---+|||+---+-+---+|+---+-+---+|+---+-+---+|||1 1|7|1 3|0 0|||+---+-+---+|||+---+-+---+|+---+-+---+|+---+-+---+|||1 1|8|1 3|0 0|||+---+-+---+|||
|     |||           |           |           ||+---+-+---+---+||           |||           |           |           ||+---+-+---+---+||           |||           |           |           ||+---+-+---+---+||           |||           |           |           ||+---+-+---+---+||           |||           |           |           ||+---+-+---+---+||           |||           |           |           ||+---+-+---+---+||           |||           |           |           ||+---+-+---+---+||           |||           |           |           ||+---+-+---+---+||           |||           |           |           ||+---+-+---+---+||           |||
|     |||           |           |           |+---------------+|           |||           |           |           |+---------------+|           |||           |           |           |+---------------+|           |||           |           |           |+---------------+|           |||           |           |           |+---------------+|           |||           |           |           |+---------------+|           |||           |           |           |+---------------+|           |||           |           |           |+---------------+|           |||           |           |           |+---------------+|           |||
|     |||           |           |           ||+---+-+---+---+||           |||           |           |           ||+---+-+---+---+||           |||           |           |           ||+---+-+---+---+||           |||           |           |           ||+---+-+---+---+||           |||           |           |           ||+---+-+---+---+||           |||           |           |           ||+---+-+---+---+||           |||           |           |           ||+---+-+---+---+||           |||           |           |           ||+---+-+---+---+||           |||           |           |           ||+---+-+---+---+||           |||
|     |||           |           |           |||1 1|0|1 3|1 0|||           |||           |           |           |||1 1|1|1 3|1 0|||           |||           |           |           |||1 1|2|1 3|1 0|||           |||           |           |           |||1 1|3|1 3|1 0|||           |||           |           |           |||1 1|4|1 3|1 0|||           |||           |           |           |||1 1|5|1 3|1 0|||           |||           |           |           |||1 1|6|1 3|1 0|||           |||           |           |           |||1 1|7|1 3|1 0|||           |||           |           |           |||1 1|8|1 3|1 0|||           |||
|     |||           |           |           ||+---+-+---+---+||           |||           |           |           ||+---+-+---+---+||           |||           |           |           ||+---+-+---+---+||           |||           |           |           ||+---+-+---+---+||           |||           |           |           ||+---+-+---+---+||           |||           |           |           ||+---+-+---+---+||           |||           |           |           ||+---+-+---+---+||           |||           |           |           ||+---+-+---+---+||           |||           |           |           ||+---+-+---+---+||           |||
|     |||           |           |           |+---------------+|           |||           |           |           |+---------------+|           |||           |           |           |+---------------+|           |||           |           |           |+---------------+|           |||           |           |           |+---------------+|           |||           |           |           |+---------------+|           |||           |           |           |+---------------+|           |||           |           |           |+---------------+|           |||           |           |           |+---------------+|           |||
|     ||+-----------+-----------+-----------+-----------------+-----------+|+-----------+-----------+-----------+-----------------+-----------+|+-----------+-----------+-----------+-----------------+-----------+|+-----------+-----------+-----------+-----------------+-----------+|+-----------+-----------+-----------+-----------------+-----------+|+-----------+-----------+-----------+-----------------+-----------+|+-----------+-----------+-----------+-----------------+-----------+|+-----------+-----------+-----------+-----------------+-----------+|+-----------+-----------+-----------+-----------------+-----------+||
|     |+-------------------------------------------------------------------+-------------------------------------------------------------------+-------------------------------------------------------------------+-------------------------------------------------------------------+-------------------------------------------------------------------+-------------------------------------------------------------------+-------------------------------------------------------------------+-------------------------------------------------------------------+-------------------------------------------------------------------+|
+-----+-------------------------------------------------------------------------------------------------------------------------------------------------------------------------------------------------------------------------------------------------------------------------------------------------------------------------------------------------------------------------------------------------------------------------------------------------------------------------------------------------------------------------------------------------------------------------------------------------------------------------------------+
